1111111111111111111
1_________________1
1_111111_1_111111_1
1____1___1___1____1
11_1_1_11111_1_1_11
1*_1_____s_____1_*1
1_11_111_1_111_11_1
1________1________1
1111_101111101_1111
0001_100000001_1000
1111_101111101_1111
0000_001gbp100_0000
1111_1011r1101_1111
0001_100000001_1000
1111_111010111_1111
1____1___1___1____1
1_11_1_11111_1_11_1
1_________________1
1*11_111_1_111_11*1
1_11_111_1_111_11_1
1________1________1
1111111111111111111
0000000000000000000
