1111111111111111111
1_________________1
1_111111_1_111111_1
1____1___1___1____1
11_1_1_11111_1_1_11
1*_1_____s_____1_*1
1_11_111_1_111_11_1
1________1________1
1111_101111101_1111
0001_100000001_1000
1111_101111101_1111
0000_001gbp100_0000
1111_1011r1101_1111
1001_100000001_1001
1001_111010111_1001
1001_1___1___1_1001
1111_1_11111_1_1111
0000___1_*_1___0000
1111_1_1_1_1_1_1111
0001_1___1___1_1000
1111_111_1_111_1111
1____111_1_111____1
1_11_____1_____11_1
1_11_111___111_11_1
1*11_101_1_101_11*1
1_11_111_1_111_11_1
1________1________1
1111111111111111111
0000000000000000000