0000000000000000000
0111111111111111110
01_______________10
01_11111_1_11111_10
01_00001_1_10000_10
01_10001_1_10001_10
01_1*0p1_1_1g0*1_10
01_11111_1_11111_10
11_______________11
00_11111_s_11111_00
11_______________11
01_11111_1_11111_10
01_1*0b1_1_1r0*1_10
01_10001_1_10001_10
01_00001_1_10000_10
01_11111_1_11111_10
01_______________10
0111111111111111110
0000000000000000000