1111111111111111
10*0_____0000*01
1111111101111111
1000*000000*0001
1010111*11110101
10101*1010010101
1010101*11010101
1010101000010101
1010101111010101
1r1g1s_____1b1p1
1111111111111111
