00000000000000000000000
01111111111111111111110
01b0_______1_______0r10
0100_11111_1_11111_0010
01*0_____1___1_____0*10
01111111_1_1_1_11111110
01_______1_1_1_______10
11_1_11111___11111_1_11
___1_______s_______1___
11_1_11111___11111_1_11
01_______1_1_1_______10
01111111_1_1_1_11111110
01*0_____1___1_____0*10
0100_11111_1_11111_0010
01p0_______1_______0g10
01111111111111111111110
00000000000000000000000
