1111111111111111111
1**1*****s_____1**1
1*11*111*1*111*11*1
1********1********1
1111*101111101*1111
1001*100000001*1001
1111*101111101*1111
1000*001gbpr00*0001
1111111111111111111
0000000000000000000
