11111111111111111
1_______________1
10011111001110001
1*0000010010000*1
10010001001000101
100100b1001g00101
10*11111__1111101
1_______________1
1_______s_______1
10*11111__1111101
100100r1001p00101
10010001001000101
10000001001000001
10011111001110001
1_______________1
11111111111111111
