0000000000000000000
1111111111111111111
_________1_________
110111_1_1_1_111011
010001_1_1_1_100010
010101_1_1_1_101010
010101___1_s_101010
010101_1_1_1_101010
010101_1_1_1_101010
010101_1_1_1_101010
01r1g1*__1__*1b1p10
0111111111111111110
0000000000000000000
