0000000000000000000
0111111111111111110
01*______1_______10
01_11111_1_10101_10
11_1r1g1_0_10101_11
00_10101_s_10101_00
11_10101_0_1b1p1_11
01_10101_1_11111_10
01_______1______*10
0111111111111111110
0000000000000000000
