1111111111111111111111111111
101r10*00000_*_0__*____1b101
10000011111_0s0_00000000*001
101p10000000000000100001g101
1111111111111111111111111111
