0000000000000000000
0111111111111111110
01*______*______*10
01_111_11111_111_10
01_1r1_10001_1b1_10
01_001__0s0__100_10
01_1g1_10001_1p1_10
01_111_11111_111_10
01*______*______*10
0111111111111111110
0000000000000000000
