0111111111111111110
01_______________10
0100111110011100010
01*0000010010000*10
0100100010010001010
0100100b1001g001010
010*11111__11111010
11_______________11
00_______s_______00
110*11111__11111011
0100100r1001p001010
0100100010010001010
0100000010010000010
0100111110011100010
01_______________10
0111111111111111110
