0000000000000000000
0111111111111111110
11_______________11
00_11_111_111_11_00
11_______________11
01_111_1_1_1_111_10
01_1___1_1_1___1_10
01_1_111_1_111_1_10
01_______________10
0111*1_11*11_1*1110
01_111_______111_10
01_1___11_11___1_10
01_1_1_______1_1_10
11___1_11g11_1___11
00_111_1b0r1_111_00
11___1_11p11_1___11
01_1_1_______1_1_10
01_1_1_11_11_1_1_10
01*1___________1*10
011111_11_11_111110
01_______________10
01_1_111_1_111_1_10
01_1___1_1_1___1_10
01_111_1_1_1_111_10
11_____1_s_1_____11
00_11_111_111_11_00
11_______________11
0111111111111111110
0000000000000000000
