1111111111111111
1p______*_____g1
1______________1
1*____________*1
1______s_______1
1*____________*1
1______________1
1r______*_____b1
1111111111111111
