1111111111111111
1______________1
1_111110011111_1
1_1r0g1s01b0p1_1
1*100011110001*1
1_100000000001_1
1_111110011111_1
1______________1
1111111111111111
