00000000000000000000000000000000
00111111111111111111111111111110
00100000000000000b00000000000010
00100000000000000000000000000010
0010000000000r000s000g0000000010
00100000000000000000000000000010
00100000000000000p00000000000010
001_1111111111111111111111111_10
001________________________*1_10
001_1111111111111111111111111_10
001_1*________________________10
001_1111111111111111111111111_10
001________________________*1_10
001_1111111111111111111111111_10
001___________________________10
00111111111111111111111111111110
00000000000000000000000000000000
00000000000000000000000000000000
