00000000000000011111000000000000
00000000000000010b01000000000000
00111111111111110001111111111110
001___*___________________*___10
001___________________________10
001___*____r_____s_____g__*___10
001___________________________10
001___*___________________*___10
00111111111111110001111111111110
00000000000000010p01000000000000
00000000000000011111000000000000
00000000000000000000000000000000
00000000000000000000000000000000
00000000000000000000000000000000
00000000000000000000000000000000
00000000000000000000000000000000
00000000000000000000000000000000
00000000000000000000000000000000
