1111111111111111
1000000000000001
1010111_11110101
10101*1_1__10101
10101_1_11_10101
10101_1____10101
10101_1111_10101
1r1g1s_____1b1p1
1111111111111111
