111111111111111111111111111111111111111111111111
1b00000000001000000000000000000100000000000000g1
101111111110101111111111111111010111101111111111
101000000010101000000000000000010000101000000101
101111111010101111111111111011111111101011110101
100000001010101*000000000*1000010000001000010101
1111111010101010_________01111010111111111110101
1000000010101010_________01000010000000000000101
1011111110101010_________*1011110111111111111101
1010000000101010_________01000010000000000000001
1010111111101010________001111010111111111110101
101000000000101*________011000010000000000010101
1011111111111010________000011110111111111010101
1010000000000010________011000010101000000010101
1010111111111010________001111010101011111010101
101010000000101*_________01000010101000000010101
1010111111101010_________01011110101111111110101
1010000000101010_________01000010100000000000101
1011111110101010_________*1111010101111111110101
100000001010101*_________01000010101000000010101
1011111010101010_________01011111101111111010101
1010000010101010_________01000000100000000010101
1010111110101010__00000__01011111111111111010101
101000001010101*000101000*1000000001000000010101
101011111010101111110111111111111101111111010101
1r100000001000100000000000000000s1000000000101p1
111111111111111111111111111111111111111111111111
